11111111111
10000000001
100P0000001
10000111C01
10000111C01
100E0000C01
10000000001
11111111111