111111111111111111
10P000C000000000C1
111101111111111101
10000000C000000101
101101111111110101
101E01111111110101
10100000000C000101
1C1111111111111101
10000000C0000000C1
111111111111111111